20230905	주식회사스캐터랩	0	4	0	7	0	11
20230911	주식회사스캐터랩	0	4	0	7	0	11
20230921	주식회사스캐터랩	0	4	0	7	0	11
20231001	주식회사스캐터랩	0	4	0	7	0	11
20231011	주식회사스캐터랩	0	4	0	7	0	11
20231021	주식회사스캐터랩	0	4	0	7	0	11
20231101	주식회사스캐터랩	0	4	0	7	0	11
20231111	주식회사스캐터랩	0	4	0	7	0	11
20231121	주식회사스캐터랩	0	4	0	7	0	11
20231201	주식회사스캐터랩	0	4	0	7	0	11
20231211	주식회사스캐터랩	0	4	0	7	0	11
20231221	주식회사스캐터랩	0	4	0	7	0	11
20240101	주식회사스캐터랩	0	4	0	7	0	11
20240111	주식회사스캐터랩	0	4	0	7	0	11
20240121	주식회사스캐터랩	0	4	0	7	0	11
20240201	주식회사스캐터랩	0	4	0	7	0	11
20240211	주식회사스캐터랩	0	2	0	7	0	9
20240221	주식회사스캐터랩	0	2	0	7	0	9
20240301	주식회사스캐터랩	0	2	0	6	0	8
20240311	주식회사스캐터랩	0	1	0	6	0	7
20240321	주식회사스캐터랩	0	1	0	6	0	7
20240401	주식회사스캐터랩	0	1	0	6	0	7
20240411	주식회사스캐터랩	0	1	0	6	0	7
20240421	주식회사스캐터랩	0	1	0	6	0	7
20240501	주식회사스캐터랩	0	1	0	6	0	7
20240511	주식회사스캐터랩	0	1	0	6	0	7
20240521	주식회사스캐터랩	0	1	0	6	0	7
20240601	주식회사스캐터랩	0	0	0	6	0	6
20240611	주식회사스캐터랩	0	0	0	6	0	6
20240621	주식회사스캐터랩	0	0	0	6	0	6
20240624	주식회사스캐터랩	0	0	0	6	0	6
20240701	주식회사스캐터랩	0	0	0	6	0	6
20240711	주식회사스캐터랩	0	0	0	6	0	6
20240721	주식회사스캐터랩	0	0	0	6	0	6
20240801	주식회사스캐터랩	0	0	0	6	0	6
20240811	주식회사스캐터랩	0	0	0	4	0	4
20240821	주식회사스캐터랩	0	0	0	4	0	4
20240901	주식회사스캐터랩	0	0	0	3	0	3
20240911	주식회사스캐터랩	0	0	0	3	0	3
20240921	주식회사스캐터랩	0	0	0	3	0	3
20241001	주식회사스캐터랩	0	0	0	3	0	3
20241011	주식회사스캐터랩	0	0	0	3	0	3
20241021	주식회사스캐터랩	0	0	0	3	0	3
20241101	주식회사스캐터랩	0	0	0	3	0	3
20241111	주식회사스캐터랩	0	0	0	3	0	3
20241121	주식회사스캐터랩	0	0	0	3	0	3
20241201	주식회사스캐터랩	0	0	0	2	0	2
20241211	주식회사스캐터랩	0	0	0	2	0	2
20241221	주식회사스캐터랩	0	0	0	2	0	2
20250101	주식회사스캐터랩	0	0	0	2	0	2
20250101	주식회사스캐터랩	0	0	0	2	0	2
20250111	주식회사스캐터랩	0	0	0	1	0	1
20250121	주식회사스캐터랩	0	0	0	1	0	1
20250201	주식회사스캐터랩	0	0	0	1	0	1
20250211	주식회사스캐터랩	0	0	0	1	0	1
